R 800 800

NO ./textures/wood.xpm

SO         ./textures/eagle.xpm

WE ./textures/greystone.xpm

EA ./textures/redbrick.xpm

S ./textures/pillar.xpm

F 184,113,39

C 100,198,227

111111
102001
100001
100001
10N001
111111
