R 40    40

NO ./textures/bluestone.xpm

SO         ./textures/eagle.xpm

WE ./textures/greystone.xpm

EA ./textures/redbrick.xpm

S ./textures/sprite.xpm

F 184,113,39

C 51,198,227

  111
  101
  101
1110111
1000001
1000001
1100011
1000001
1000001
1000001
1000001
1110111
  101
  101
  111
  111
   111111111111111111111
111100000000000000000001111
1000000000000000000000E0001
111110000000000000000001111
    11111111111111111111
