R 700  700

NO ./textures/wood.xpm

SO         ./textures/eagle.xpm

WE ./textures/greystone.xpm

EA ./textures/redbrick.xpm

S ./textures/pillar.xpm

F 184,113,39

C 100,198,227
  111
  1001
  101
1110111
1000001
1000001
1100011      111
1000001111111121111111111111111111111111
10000000000020020000000022222222000000111111
1000001000000000000000000000000000000011
100000111111110111111111111111111111111
1110111      101
  101        101
  101        101
  101        101
  101        101
  1011111111110111111111
111000000000000000000001111
1000000002000000002000000001
100000000000000222222000000011
100000000000002222222220000001
1000000000000222222200000000001
10000000000000N000022000000011
1000000000000000000000000001
1111100000000000000000011111
   111111111111011111111111
               1
