R 1000  700

NO ./textures/wood.xpm

SO         ./textures/eagle.xpm

WE ./textures/greystone.xpm

EA ./textures/redbrick.xpm

S ./textures/sprite.xpm

F 184,113,39

C 51,198,227

  111
  101
  101
1110111
1000001
1000001
1100011
1000001111111111111111111111111111111
100000000000000000000000000000000111111
100000100000000000000000000000000000001
100N00111111111111111111111111111111111
1110111
  101
  101
  101
  101
  1011111111111111111111
111000000000000000000001111
100000000000000000000000001
111110000000000000000001111
    11111111111111111111
