R 1000  700

NO ./textures/wood.xpm

SO         ./textures/eagle.xpm

WE ./textures/greystone.xpm

EA ./textures/redbrick.xpm

S ./textures/sprite.xpm

F 184,113,39

C 51,198,227

111111111111
100000000001
100011100001
10001 1000001
10001 10000011111
1000000000011
1000000000011111
100000000001
100000000001
1000000000011111111
1000000000000000001
10000E0000011111111
111111111111
