R 1000  700

NO ./textures/wood.xpm

SO         ./textures/eagle.xpm

WE ./textures/greystone.xpm

EA ./textures/redbrick.xpm

S ./textures/barrel.xpm

F 184,113,39

C 51,198,227

111111111111   111111
100000000001   100001
100011100001   100001
100011100001   100001
100011100001   100001
100200020001   100001
100000000001   100001
100000000001   100001
100000000001   111111
100000000001
100000000001
100000N00001
111111111111
