R 1000 600
NO ./textures/wood.xpm
SO ./textures/eagle.png

WE ./textures/redbrick.xpm
EA ./textures/greystone.png

S ./textures/pillar.xpm





F 21,90,114

C 98,33,32

        111
        101
        101
        101
        10111111111111
        10000000000011
        10111111111111
        101
        101
        10111111111111111 1111111
        10000000001101111 1000001
        100100E0000101    1100001
        1001011110000111111100001
11111111101101  11110000000000001
11111111101111  11111000111111111
        101         10011
        101    1111110111
11111111101    1000000011
10000000001    1111111111
11101101121
1111110111111111111111111111111111111111
1111110111111111
11111101111
1111110111111111111111111111111111111111
1111110111111111
11111101111
1111110111111111111111111111111111111111
1111110111111111
11111101111
1111110111111111111111111111111111111111
1111110111111111
11111101111
1111110111111111111111111111111111111111
1111110111111111
11111101111
10000000111111
1011111111
1001111111
1000111111
111000011111
111011111
111011111
1110111111
111001111
1111111111
1111111111
111111111
1111111111
111111111
1111111111
1111
1
1
1
1
1
1
1
1
1
1
11111111111
