R 1080 720
SO ./textures/redbrick.png
NO ./textures/greystone.png
EA ./textures/wood.png
WE ./textures/wood.png
S ./textures/barrel.png
C 255,200,160
F 122,122,122

11111111111111111
10000000000000001
10000000000000001
10020020020000001
10020000000000001
10020000000000001
10020000N00000001
10000000000000001
10000000000000001
10000000000000001
10000000000000001
10000000000000001
11111111111111111
