R  918 468
NO ./textures/brick.xpm
SO ./textures/blue.xpm

WE ./textures/wood.xpm
EA ./textures/grey.xpm

S ./textures/wolf/guard.xpm





F 112,112,112

C 56,56,56



        11111111111111111 1111111
        10000000001101111 1000001
        10010000011101    1200001
        10010111100001111 1000001
11111111101101  11110000111000001
11111111111111  11111111111111111
