
NO ./textures/redbrick.xpm
SO ./textures/eagle.xpm

C 36,56,56

F 112,112,144
WE ./textures/wood.xpm
EA ./textures/greystone.xpm

S ./textures/pillar.xpm









R  600 850



        1111111111111111111111111
        1000000000110000000000001
        1001000001110000000200001
        1001000000000111000000001
1111111110110000011101  100000001
100000000011000001110111111111111
10010111111111011100000010001
11110111111111011101010010201
11000000110101011100000011111
1200000000000000110000001
1200N000000000001101010011111
11111111011111100111111110001
1100000111010111111011110001111111111111111111
11110111 111001  11111010201
11111111 111111  11111111111111
