R 500  500

  SO ./textures/redbrick.xpm
NO ./textures/greystone.xpm
EA ./textures/wood.xpm

WE   ./textures/wood.xpm
S  ./textures/barrel.xpm
C 55,200      ,   160
F 32,122  , 122 
11111111111111111
10000000000000001
10000000000000001
10020020002000001
10020000000000001
10020000000000001
10020000000000001
10000000N00000001
10000000000000001
10000000000000001
10000000000000001
10000000000000001
11111111111111111
