R  800 600
NO ./textures/brick.xpm
SO ./textures/blue.xpm

WE ./textures/wood.xpm
EA ./textures/grey.xpm

S ./textures/wolf/guard.xpm





F 112,112,112

C 56,56,56

        111
        101
        101
        101
        101
        101
        101
        101
        101
        10111111111111111 1111111
        10000000001101111 1000001
        100100E0000101    1100001
        1001011110000111111100001
11111111101101  11110000000000001
11111111101111  11111000111111111
        101         10011
        101    1111110111
11111111101    1000000011
10000000001    1111111111
11101101121
1111110111111111111111111111111111111111
1111110111111111
11111101111
1111110111111111111111111111111111111111
1111110111111111
11111101111
1111110111111111111111111111111111111111
1111110111111111
11111101111
1111110111111111111111111111111111111111
1111110111111111
11111101111
1111110111111111111111111111111111111111
1111110111111111
11111101111
1111110111111
1111111111
1111111111
111111111
1111111111
111111111
111111111
1111111111
1111111111
1111111111
1111111111
111111111
1111111111
111111111
1111111111
1111
1
1
1
1
1
1
1
1
1
1
11111111111
