R  918 468
NO ./textures/brick.xpm
SO ./textures/blue.xpm

WE ./textures/wood.xpm
EA ./textures/grey.xpm

S ./textures/wolf/guard.xpm





F 112,112,112

C 56,56,56



        11111111111111111 1111111
        10000000001101111 1000001
        100100N0000101    1100001
        1001011110000111111100001
11111111101101  11110000000000001
11111111101111  11111000111111111
        101         10011
        101    1111110111
11111111101    1000000011
10000000001    1111000211
11101111111    1111111111
11101          101
11101111111111110111111111111111111111111
1110000000000000000000000001111
1110111111111111111111111111
11101   111
11101
1110111111
1110000001
1111110111
    1001111111111111111
    1000000000000000001
    1111111111111111111
    111111111
     11111111111111111111
