R  300 300
NO ./textures/brick.xpm
SO ./textures/blue.xpm

WE ./textures/wood.xpm
EA ./textures/grey.xpm

S ./textures/wolf/guard.xpm





F 112,112,112

C 56,56,56



        1111111111111111111111111
        1000000000110000000000001
        1001000001110000000200001
        1001000000000000000000001
111111111011000001110000000000001
100000000011000001110111111111111
10010111111111011100000010001
11110111111111011101010010201
11000000110101011100000011111
1000000000000000110000001
1000N000000000001101010011111
11111111011111100111111110001
1100000111010111111011110001111111111111111111
11110111 111001  11111010001
11111111 111111  11111111111111
